00,00,00,00,00,00,00,00,00,00,00,00,00,00,00,00,00,00,00,00,00,00
00,00,00,00,00,00,00,00,00,00,00,00,00,00,00,00,00,00,00,00,00,00
00,00,10,10,10,10,10,10,10,10,10,10,10,10,10,10,10,10,10,10,00,00
00,00,11,11,11,11,11,11,11,11,11,11,11,11,11,11,11,11,11,11,00,00
00,00,03,03,03,03,03,03,03,03,03,03,03,03,03,03,03,03,03,03,00,00
00,00,03,03,03,03,03,03,03,03,03,03,03,03,03,03,03,03,03,03,00,00
00,00,03,03,03,03,03,03,03,03,03,03,03,03,03,03,03,03,03,03,00,00
00,00,03,03,03,03,03,03,03,03,03,03,03,03,03,03,03,03,03,03,00,00
00,00,03,03,03,03,03,03,03,03,03,03,03,03,03,03,03,03,03,03,00,00
00,00,03,03,03,03,03,03,03,03,03,03,03,03,03,03,03,03,03,03,00,00
00,00,03,03,03,03,03,03,03,03,03,03,03,03,03,03,03,03,03,03,00,00
00,00,03,03,03,03,03,03,03,03,03,03,03,03,03,03,03,03,03,03,00,00
00,00,03,03,03,03,03,03,03,03,03,03,03,03,03,03,03,03,03,03,00,00
00,00,03,03,03,03,03,03,03,03,03,03,03,03,03,03,03,03,03,03,00,00
00,00,03,03,03,03,03,03,03,03,03,03,03,03,03,03,03,03,03,03,00,00
00,00,03,03,03,03,03,03,03,03,03,03,03,03,03,03,03,03,03,03,00,00
00,00,03,03,03,03,03,03,03,03,03,03,03,03,03,03,03,03,03,03,00,00
00,00,03,03,03,03,03,03,03,03,03,03,03,03,03,03,03,03,03,03,00,00
00,00,00,00,00,00,00,00,00,00,00,00,00,00,00,00,00,00,00,00,00,00
00,00,00,00,00,00,00,00,00,00,00,00,00,00,00,00,00,00,00,00,00,00

1,1,1,1,1,1,1,1,1,1,1,1,1,1,1,1,1,1,1,1,1,1
1,1,1,1,1,1,1,1,1,1,1,1,1,1,1,1,1,1,1,1,1,1
1,1,1,1,1,1,1,1,1,1,1,1,1,1,1,1,1,1,1,1,1,1
1,1,1,1,1,1,1,1,1,1,1,1,1,1,1,1,1,1,1,1,1,1
1,1,0,0,0,0,0,0,0,0,0,0,0,0,0,0,0,0,0,0,1,1
1,1,0,0,0,0,0,0,0,0,0,0,0,0,0,0,0,0,0,0,1,1
1,1,0,0,0,0,0,0,0,0,0,0,0,0,0,0,0,0,0,0,1,1
1,1,0,0,0,0,0,0,0,0,0,0,0,0,0,0,0,0,0,0,1,1
1,1,0,0,0,0,0,0,0,0,0,0,0,0,0,0,0,0,0,0,1,1
1,1,0,0,0,0,0,0,0,0,0,0,0,0,0,0,0,0,0,0,1,1
1,1,0,0,0,0,0,0,0,0,0,0,0,0,0,0,0,0,0,0,1,1
1,1,0,0,0,0,0,0,0,0,0,0,0,0,0,0,0,0,0,0,1,1
1,1,0,0,0,0,0,0,0,0,0,0,0,0,0,0,0,0,0,0,1,1
1,1,0,0,0,0,0,0,0,0,0,0,0,0,0,0,0,0,0,0,1,1
1,1,0,0,0,0,0,0,0,0,0,0,0,0,0,0,0,0,0,0,1,1
1,1,0,0,0,0,0,0,0,0,0,0,0,0,0,0,0,0,0,0,1,1
1,1,0,0,0,0,0,0,0,0,0,0,0,0,0,0,0,0,0,0,1,1
1,1,0,0,0,0,0,0,0,0,0,0,0,0,0,0,0,0,0,0,1,1
1,1,1,1,1,1,1,1,1,1,1,1,1,1,1,1,1,1,1,1,1,1
