15,15,15,15,15,15,15,15,15,15,15,15,15,15,15,15,15,15,15,15,15,15,15,15,15,15,15,15
15,15,15,15,15,15,15,15,15,15,15,15,15,15,15,15,15,15,15,15,15,15,15,15,15,15,15,15
15,15,15,15,15,15,15,15,15,15,15,15,15,15,15,15,15,15,15,15,15,15,15,15,15,15,15,15
15,15,15,04,05,04,05,04,05,04,05,04,05,04,05,04,05,04,05,04,05,04,05,04,05,15,15,15
15,15,15,05,04,05,04,05,04,05,04,05,04,05,04,05,04,05,04,05,04,05,04,05,04,15,15,15
15,15,15,04,05,04,05,04,05,04,05,04,05,04,05,04,05,04,05,04,05,04,05,04,05,15,15,15
15,15,15,05,04,05,04,06,07,08,09,05,04,05,04,05,04,05,04,05,04,05,04,05,04,15,15,15
15,15,15,04,05,04,05,16,17,18,19,04,05,04,05,04,05,04,05,04,05,04,05,04,05,15,15,15
15,15,15,05,04,05,04,26,27,28,29,05,04,05,04,05,04,05,04,05,04,05,04,05,04,15,15,15
15,15,15,04,05,14,14,36,37,38,39,14,14,04,05,04,05,04,05,04,05,04,05,04,05,15,15,15
15,15,15,05,04,14,04,04,15,02,04,04,14,05,04,05,04,05,04,05,04,05,04,05,04,15,15,15
15,15,15,04,05,14,04,04,15,02,04,04,14,04,05,04,05,04,05,04,05,04,05,04,05,15,15,15
15,15,15,05,04,14,04,04,02,02,04,04,14,05,04,05,04,05,04,05,04,05,04,05,04,15,15,15
15,15,15,04,05,14,14,14,02,02,14,14,14,04,05,04,05,04,05,04,05,04,05,04,05,15,15,15
15,15,15,05,04,05,04,05,04,05,04,05,04,05,04,05,04,05,04,05,04,05,04,05,04,15,15,15
15,15,15,04,05,04,05,15,05,04,15,04,05,04,05,04,05,04,05,04,05,04,05,04,05,15,15,15
15,15,15,05,04,05,04,05,04,05,04,05,04,05,04,05,04,05,04,05,04,15,15,05,04,15,15,15
15,15,15,04,05,04,05,15,05,04,15,04,05,04,05,04,05,04,05,04,15,15,15,04,05,15,15,15
15,15,15,05,04,05,04,05,04,05,04,05,04,05,04,05,04,05,04,15,15,15,15,05,04,15,15,15
15,15,15,04,05,04,05,04,05,04,05,04,05,04,05,04,05,04,15,15,15,15,15,04,05,15,15,15
15,15,15,05,04,05,04,05,04,05,04,05,04,05,04,05,04,15,15,15,15,15,15,05,04,15,15,15
15,15,15,04,05,04,05,04,05,04,05,04,05,04,05,04,05,15,15,15,15,15,15,04,05,15,15,15
15,15,15,05,04,05,04,05,04,05,04,05,04,05,04,05,04,05,04,05,04,05,04,05,04,15,15,15
15,15,15,15,15,15,15,15,15,15,15,15,15,15,15,15,15,15,15,15,15,15,15,15,15,15,15,15
15,15,15,15,15,15,15,15,15,15,15,15,15,15,15,15,15,15,15,15,15,15,15,15,15,15,15,15
15,15,15,15,15,15,15,15,15,15,15,15,15,15,15,15,15,15,15,15,15,15,15,15,15,15,15,15

0,0,0,0,0,0,0,0,0,0,0,0,0,0,0,0,0,0,0,0,0,0,0,0,0,0,0,0
0,0,0,0,0,0,0,0,0,0,0,0,0,0,0,0,0,0,0,0,0,0,0,0,0,0,0,0
0,0,1,1,1,1,1,1,1,1,1,1,1,1,1,1,1,1,1,1,1,1,1,1,1,1,0,0
0,0,1,0,0,0,0,0,0,0,0,0,0,0,0,0,0,0,0,0,0,0,0,0,0,1,0,0
0,0,1,0,0,0,0,0,0,0,0,0,0,0,0,0,0,0,0,0,0,0,0,0,0,1,0,0
0,0,1,0,0,0,0,0,0,0,0,0,0,0,0,0,0,0,0,0,0,0,0,0,0,1,0,0
0,0,1,0,0,0,0,1,1,1,1,0,0,0,0,0,0,0,0,0,0,0,0,0,0,1,0,0
0,0,1,0,0,0,0,1,1,1,1,0,0,0,0,0,0,0,0,0,0,0,0,0,0,1,0,0
0,0,1,0,0,0,0,1,1,1,1,0,0,0,0,0,0,0,0,0,0,0,0,0,0,1,0,0
0,0,1,0,0,1,1,1,1,0,1,1,1,0,0,0,0,0,0,0,0,0,0,0,0,1,0,0
0,0,1,0,0,1,0,0,1,0,0,0,1,0,0,0,0,0,0,0,0,0,0,0,0,1,0,0
0,0,1,0,0,1,0,0,1,0,0,0,1,0,0,0,0,0,0,0,0,0,0,0,0,1,0,0
0,0,1,0,0,1,0,0,0,0,0,0,1,0,0,0,0,0,0,0,0,0,0,0,0,1,0,0
0,0,1,0,0,1,1,1,0,0,1,1,1,0,0,0,0,0,0,0,0,0,0,0,0,1,0,0
0,0,1,0,0,0,0,0,0,0,0,0,0,0,0,0,0,0,0,0,0,0,0,0,0,1,0,0
0,0,1,0,0,0,0,1,0,0,1,0,0,0,0,0,0,0,0,0,0,0,0,0,0,1,0,0
0,0,1,0,0,0,0,0,0,0,0,0,0,0,0,0,0,0,0,0,0,1,1,0,0,1,0,0
0,0,1,0,0,0,0,1,0,0,1,0,0,0,0,0,0,0,0,0,1,0,1,0,0,1,0,0
0,0,1,0,0,0,0,0,0,0,0,0,0,0,0,0,0,0,0,1,0,0,1,0,0,1,0,0
0,0,1,0,0,0,0,0,0,0,0,0,0,0,0,0,0,0,1,0,0,0,1,0,0,1,0,0
0,0,1,0,0,0,0,0,0,0,0,0,0,0,0,0,0,1,0,0,0,0,1,0,0,1,0,0
0,0,1,0,0,0,0,0,0,0,0,0,0,0,0,0,0,1,1,1,1,1,1,0,0,1,0,0
0,0,1,0,0,0,0,0,0,0,0,0,0,0,0,0,0,0,0,0,0,0,0,0,0,1,0,0
0,0,1,1,1,1,1,1,1,1,1,1,1,1,1,1,1,1,1,1,1,1,1,1,1,1,0,0
0,0,0,0,0,0,0,0,0,0,0,0,0,0,0,0,0,0,0,0,0,0,0,0,0,0,0,0
0,0,0,0,0,0,0,0,0,0,0,0,0,0,0,0,0,0,0,0,0,0,0,0,0,0,0,0

